CODICI

\" = VIRGOLETTE
|p| = PAUSA
\n = LINEBREAK
|skip| = SKIP
|style color gray| = TESTO COLOR GRIGIO
marker branchX = TESTO SEGUENTE FA RIFERIMENTO A UN BRANCH SPECIFICO




TERMINOLOGIE ( - Nome cartella)

Photosensitivity Warning = Avvertenze per Fotosensibili - loc\en

Custom (Modalità) = Personaliz. - loc\en

Endless (Modalità) = Senza Fine - loc\en

Local high Scores = Record in Locale - loc\en

Submenu = Sottomenù - loc\en

Lose focus (finestre del PC) = perde il focus (passa in secondo piano?) - loc\en

Contestant = Partecipante

Platinum Ticket = Biglietto di Platino

Pools round = Fasi a girone

Entry system = Sistema d'iscrizione

Gate = Tornelli

Hooked in = Collegato

Microgame = Microgioco

Interface = Interfaccia

Prize Money = Montepremi/Vincita (in base al contesto)

Machine = Macchinario (es. Mindwave Machine - Macchinario Mindwave)

Purple Girl = Ragazza in Viola (placeholder) - Abbie

Mall = Centro Commerciale (placeholder) - Abbie e altri

Hobby shop = Bottega - Abbie

Yarn = Filato - Abbie

Sparkly yarn = Filato sfavillante - Abbie

Ball of sparkly yarn = Gomitolo sfavillante - Abbie

Bad parts (of the city) = Quartieri malfamati - Abbie

Plushy = Peluche - Abbie

Transit pass = Abbonamento - Abbie

Open-back = (Cuffie) aperte - Alex

Evil-ass = maligno del cazzo (riferito all'edificio) - Iris

Varsity Team = Team della scuola - Roxy

Headspace = Mentalità - Roxy

Professional (relativo al giocare a Mindwave) = Competitivo - Roxy

Side effect = Complicanza - Roxy

Mental model = Forma mentis - Roxy

Memory channeling = Canalizzazione dei ricordi - Roxy

Show = Serie (riferito a Fortress of Sorrow) - Kat&Slate

Dork = Sfigato - Kat&Slate

Art studio (abbreviato anche in studio) = Atelier - Kat&Slate

Dormant Exile (nome in una serie fictionale) = Esule Dormiente - Kat&Slate

Trippy = Intrippante - Kat&Slate

Randoms = Normaloni - Kat&Slate

Corporate shill = leccare gli stivali dell'azienda - Smalls

Dweeb = Fallito - Smalls





FRASI TIPO (INDICATIVO) ( - Nome cartella)

A volte alcune frasi si ripetono nelle varie possibili route di dialogo (es. i momenti di scambio dei numeri)
NOTA: ALCUNE VOLTE LE FRASI PRESENTANO LEGGERE VARIAZIONI

That's what the Interface is for! = L'Interfaccia serve a questo! - sezione tutorial

SLAM to attention = (gioco di parole con snap to attention) - sezione tutorial

Hell yeah = Sì, cazzo - Abbie e altri

Move back home = Tornare alla vecchia casa - Abbie (route BAB)

Before you go = Prima che te ne vai - Abbie (saluti)

Here's mine = Il mio è questo - Abbie e altri (scambio numeri)

I'll just give you Panda's too = Ti daro' anche quello di Panda - Abbie e altri (scambio numeri)

Man = Dai (esasperazione) - Vari

Duuuude = Assuuuurdo - Kat&Slate

Cya! = Ci si becca! - Kat&Slate

Peace! = Statemi bene! - Kat&Slate

Well, damn = Beh, che dire - Smalls